G G G G R G G G G G
G G G G R R G G G G
G G G G G R R R G G
G G M M G G G R R G
G G M M M G G G R G
G G G M M M M G G G
G G G G G M M M G G
G G G G G G M M M M
G G G G G G G M M M
G G G G G G G G G G
