M M G G G R G G
M G G R R G G G
G G R G G G G G
R R R G G G G G
G G G R R R G G
G G G G G G G G
